15,2,2,2,2,2,2,2,2,2,2,2,2,2,2,2,2,2,2,2,2,2,2,2,2,2,2,2,2,2,2,2,2,2,2,2,2,2,2,3,2,2,2,2,2,2,2,2,2,2,2,2,2,2,3,2,2,2,2,2,2,2,2,2,3,2,2,2,2,2,2,2,2,2,2,2,2,2,2,2,2,2,2,2,16,14,14,14,14,14,14,14,14,14,14,14,14,14,14,14
1,0,0,0,0,0,0,0,0,0,0,0,0,0,0,0,0,0,0,0,0,0,0,0,0,0,0,0,0,0,0,0,0,0,0,0,0,0,0,1,0,0,0,0,0,0,0,0,0,0,0,0,0,27,1,0,0,0,0,0,0,0,0,0,1,0,0,0,0,0,0,0,0,0,0,0,0,0,0,0,0,0,0,0,1,14,14,14,14,14,14,14,14,14,14,14,14,14,14,14
1,0,0,0,0,0,0,0,0,0,0,0,0,12,0,0,0,0,0,0,0,0,0,0,0,0,13,0,0,0,0,0,0,0,0,0,0,0,0,1,0,13,0,0,0,0,0,0,0,0,0,0,0,0,1,0,0,12,0,0,0,0,0,0,22,0,0,0,0,0,0,0,0,0,0,0,0,0,0,0,0,0,0,0,1,14,14,14,14,14,14,14,14,14,14,14,14,14,14,14
1,0,0,0,0,0,0,0,0,0,0,0,0,12,0,0,0,0,0,0,0,0,0,0,0,0,13,0,0,0,0,0,0,0,0,0,0,0,0,1,0,0,13,0,0,0,0,0,0,0,0,12,0,26,1,0,0,0,0,0,0,0,0,0,24,0,0,0,0,0,0,0,0,26,0,0,0,0,0,0,0,0,0,0,1,14,14,14,14,14,14,14,14,14,14,14,14,14,14,14
1,0,0,0,0,26,0,0,26,0,0,0,0,12,0,0,0,0,26,0,0,26,0,0,0,0,13,0,0,0,0,0,0,0,0,0,0,0,0,1,0,0,0,13,0,0,0,0,0,0,0,0,0,26,1,27,0,12,0,0,13,0,0,0,24,0,0,0,0,0,0,0,0,0,0,0,0,0,0,0,0,0,0,0,1,14,14,14,14,14,14,14,14,14,14,14,14,14,14,14
1,0,0,0,0,0,0,0,0,0,0,0,0,12,0,0,0,0,0,0,0,0,0,0,0,0,13,0,0,0,0,0,0,0,0,0,0,0,0,1,0,0,0,0,13,0,0,0,0,0,0,12,0,26,1,0,0,12,0,0,0,13,0,0,24,0,0,0,0,0,0,0,0,0,0,0,0,0,0,0,0,0,0,0,17,2,2,2,2,2,2,2,2,2,2,3,2,3,3,16
1,0,0,0,0,0,0,0,0,0,0,0,0,0,0,0,0,0,0,0,0,0,0,0,0,0,0,0,0,0,0,0,0,0,0,0,0,0,0,1,0,0,0,0,0,0,0,0,0,0,0,0,0,26,1,0,0,0,0,0,0,0,0,0,24,0,0,0,0,0,26,0,0,26,0,0,26,0,0,0,0,0,0,0,0,0,0,0,0,0,0,0,0,0,0,22,0,22,1,1
4,2,2,2,2,2,2,2,2,2,2,2,2,2,2,2,2,2,2,2,2,2,2,2,2,2,2,2,2,2,2,2,2,2,7,0,0,0,0,1,0,0,0,0,0,0,0,0,0,0,0,12,0,0,1,0,0,12,0,0,0,0,0,0,24,0,0,0,0,0,0,0,0,0,0,0,0,0,0,0,0,0,0,0,0,0,0,0,0,0,0,0,0,0,0,24,0,24,1,1
1,0,0,0,0,0,0,0,0,0,0,0,0,0,0,0,0,0,0,0,0,0,0,0,0,0,0,0,0,0,0,0,0,0,0,0,0,0,0,1,0,0,0,0,0,0,0,0,0,0,0,0,0,0,1,0,0,0,0,0,0,0,0,0,23,0,0,0,0,0,0,0,0,0,0,0,0,0,0,0,0,13,0,0,0,0,0,0,0,26,0,0,0,26,0,24,0,24,9,1
1,0,0,0,0,0,0,0,0,0,0,0,0,0,0,0,0,0,0,0,0,0,0,0,0,0,0,0,0,0,0,0,0,0,0,0,0,0,0,1,0,0,0,0,0,0,0,0,15,2,2,2,2,2,6,2,2,2,2,2,3,2,2,2,18,0,0,0,0,0,0,0,0,26,0,0,0,0,0,0,0,0,0,0,0,0,0,0,0,0,0,0,0,0,0,24,0,24,0,1
1,0,0,0,0,0,0,0,0,0,0,0,0,0,0,0,12,0,0,0,0,0,13,0,0,0,0,0,0,0,0,0,0,0,0,0,26,26,0,1,0,0,0,0,0,0,0,0,1,14,14,14,14,14,14,14,14,14,14,14,1,0,0,0,0,0,0,0,0,0,0,0,0,0,0,0,0,0,0,13,0,0,0,0,0,0,0,0,0,0,0,0,0,0,0,24,0,24,14,1
1,0,0,0,0,0,0,0,0,0,0,0,0,0,0,0,0,0,0,0,0,0,0,0,0,0,0,0,0,0,0,0,0,0,0,0,0,0,0,1,0,0,0,0,0,0,0,0,1,14,14,14,14,14,14,14,14,14,14,14,1,0,0,0,0,15,2,2,2,2,2,2,2,2,16,0,0,13,0,0,0,0,0,0,0,0,0,0,0,0,0,0,0,0,0,24,0,24,0,1
1,0,0,0,0,0,0,0,0,0,0,0,0,0,0,0,0,0,0,0,0,0,0,0,0,0,0,0,0,0,0,0,0,0,0,0,0,0,0,1,0,0,0,0,0,0,0,0,1,14,14,14,14,14,14,14,14,14,14,14,1,0,0,0,0,1,14,14,14,14,14,14,14,14,17,16,0,0,0,0,0,0,0,0,0,0,0,0,0,26,0,0,0,26,0,24,0,24,10,1
1,0,0,0,0,0,0,0,0,0,8,2,2,2,2,2,2,2,2,2,2,2,2,2,2,2,2,2,2,2,2,2,2,7,0,0,0,0,0,4,20,11,11,11,11,11,11,21,5,14,14,14,14,14,14,14,14,14,14,14,1,0,0,0,0,1,14,14,14,14,14,14,14,14,14,17,16,0,0,0,0,0,0,0,0,0,0,0,0,0,0,0,0,0,0,24,0,24,1,1
1,0,0,0,0,0,0,0,0,0,0,0,0,0,0,0,0,0,0,0,0,0,0,0,0,0,0,0,0,0,0,0,0,0,0,0,0,0,0,1,0,0,0,0,0,0,0,0,1,14,14,14,14,14,14,14,14,14,14,14,1,0,0,0,0,1,14,14,15,2,2,16,14,14,14,14,17,16,0,0,0,0,0,0,0,0,0,0,0,0,0,0,0,0,0,23,0,23,1,1
1,0,0,0,0,0,0,0,0,0,0,13,0,0,0,0,0,0,0,0,0,0,0,0,0,0,0,0,0,0,0,0,0,0,0,0,0,0,0,1,0,0,0,0,0,0,0,0,1,14,14,14,14,14,14,14,14,14,14,14,1,0,0,0,0,1,14,14,1,0,0,17,16,14,14,14,14,17,16,0,0,0,0,15,2,2,2,2,2,2,2,2,2,2,2,6,2,6,6,18
1,0,0,0,0,0,0,0,0,0,0,0,0,0,0,0,0,0,0,0,0,0,0,0,0,12,0,0,0,0,0,0,0,0,0,0,0,0,0,1,0,0,0,0,0,0,0,0,1,14,14,14,14,14,14,14,14,14,14,14,1,0,0,0,0,1,14,14,1,0,0,0,17,16,14,14,14,14,17,16,0,0,0,1,14,14,14,14,14,14,14,14,14,14,14,14,14,14,14,14
1,0,0,0,0,0,0,0,13,0,0,0,0,0,0,0,0,0,0,0,0,0,0,0,0,0,12,0,0,0,0,0,0,0,0,0,0,0,0,1,0,0,0,0,0,0,0,0,17,2,2,2,2,2,3,2,2,2,2,2,18,0,0,0,0,1,14,14,1,0,0,0,0,17,16,14,14,14,14,1,0,0,0,1,14,14,14,14,14,14,14,14,14,14,14,14,14,14,14,14
1,0,0,0,0,0,0,0,0,0,0,0,0,0,0,15,2,2,2,2,16,0,0,0,0,0,0,12,0,0,0,0,0,0,0,0,0,0,0,1,0,0,0,0,0,0,0,0,0,0,0,0,0,0,1,0,0,0,0,0,0,0,0,0,0,1,14,14,1,0,0,0,0,0,1,14,14,14,14,1,0,0,0,1,14,14,14,14,14,14,14,14,15,2,2,2,2,2,2,16
1,0,0,0,0,13,0,0,0,0,0,0,0,0,0,1,0,0,0,0,1,0,0,0,0,0,0,0,0,0,0,0,0,0,0,0,0,13,0,1,0,0,0,0,0,0,0,0,0,0,0,0,0,0,1,0,0,0,0,0,0,0,0,0,0,1,14,14,1,0,0,0,0,0,1,14,14,14,14,1,0,0,0,1,14,14,14,14,14,14,14,14,1,0,0,0,0,26,27,1
1,0,0,0,0,0,0,0,0,0,0,0,0,15,2,18,0,0,0,0,1,0,0,0,0,0,0,0,0,0,0,0,0,0,0,0,13,0,0,1,0,0,0,0,0,0,0,0,0,13,0,0,0,0,1,0,0,0,0,0,0,0,0,0,0,1,14,14,1,0,0,0,0,0,1,14,14,14,14,1,0,0,0,1,14,14,14,14,14,14,14,14,1,0,0,0,0,0,26,1
1,0,0,26,0,0,0,0,0,0,12,0,0,1,0,0,0,27,0,0,1,0,0,0,0,0,0,0,0,0,0,0,0,0,0,13,0,0,0,1,0,0,0,12,0,0,0,0,0,0,0,0,0,0,9,0,0,0,0,0,0,0,0,0,0,1,14,14,1,0,0,0,15,2,18,14,14,14,15,18,0,0,0,1,14,14,14,14,14,14,14,14,1,0,12,0,0,0,0,1
1,0,0,0,0,26,0,0,0,0,0,0,0,1,0,0,0,0,0,0,1,0,0,0,0,0,0,0,0,0,0,0,0,0,0,0,0,0,26,1,0,0,0,0,0,0,0,0,0,0,0,0,0,0,0,0,0,0,12,0,0,0,0,0,0,1,14,14,17,2,2,2,18,14,14,14,14,15,18,0,0,0,0,1,14,14,14,14,14,14,14,14,1,0,0,12,0,0,0,1
1,0,0,0,0,0,0,0,0,0,0,0,0,1,0,13,0,0,13,0,1,0,0,0,0,0,0,0,0,0,0,0,0,0,0,0,0,26,27,1,0,0,0,0,0,12,12,0,0,0,0,0,0,0,0,0,0,0,12,0,0,0,0,0,0,1,14,14,14,14,14,14,14,14,14,15,2,18,0,0,0,0,0,1,14,14,14,14,14,14,14,14,1,0,0,0,12,0,0,1
1,0,0,12,0,0,0,0,0,0,0,0,0,1,0,0,0,0,0,0,4,2,2,2,2,2,2,2,2,2,2,2,2,2,2,2,2,2,2,5,0,0,0,0,0,0,0,0,0,0,0,0,0,0,0,0,0,0,12,0,0,0,0,0,0,1,14,14,14,14,14,14,14,15,2,18,0,0,0,0,0,0,0,1,14,14,14,14,14,14,14,14,1,0,0,13,0,12,0,1
1,0,0,0,0,0,0,0,0,15,2,2,2,18,0,0,0,0,0,0,1,14,14,14,14,14,14,14,14,14,14,14,14,14,14,14,14,14,14,1,0,0,0,0,0,0,0,0,12,0,0,0,0,0,0,0,0,0,12,0,0,0,0,0,0,17,2,2,2,2,2,2,2,18,0,0,0,0,0,0,0,0,0,1,14,14,14,14,14,14,14,14,1,0,0,0,0,0,0,1
1,0,0,0,0,0,0,0,0,1,0,0,0,0,0,0,0,0,0,0,1,14,14,14,14,14,14,14,14,14,14,14,14,14,14,14,14,14,14,1,0,0,0,13,0,0,0,0,0,0,0,0,0,0,10,0,0,0,0,0,0,0,0,0,0,0,0,0,0,0,0,0,0,0,0,0,0,13,0,0,0,0,0,1,14,14,14,14,14,14,14,14,1,0,0,0,0,0,0,1
1,0,0,0,0,0,0,0,0,1,0,0,26,0,0,0,0,0,0,0,1,14,14,14,14,14,14,14,14,14,14,14,14,14,14,14,14,14,14,1,0,0,0,0,0,0,0,0,0,0,0,0,0,0,1,0,0,0,0,0,0,0,0,0,0,0,0,0,0,0,0,0,0,0,0,0,0,0,13,0,0,0,0,17,2,2,2,2,2,2,2,2,18,0,0,0,0,0,0,1
1,0,0,0,0,0,12,0,0,1,0,12,0,12,0,0,0,0,0,0,1,14,14,14,14,14,14,14,14,14,14,14,14,14,14,14,14,14,14,1,0,0,0,0,0,0,0,0,0,0,0,0,0,0,1,0,0,0,0,0,0,0,0,0,0,0,0,0,0,0,0,0,0,0,0,0,0,0,0,13,0,0,0,0,0,0,0,0,0,0,0,0,0,0,0,0,0,0,0,1
1,0,0,0,0,0,0,0,0,1,0,0,0,0,0,0,0,0,0,0,1,14,14,14,14,14,14,14,14,14,14,14,14,14,14,14,14,14,14,1,0,0,0,0,0,0,0,0,0,0,0,0,0,0,1,0,0,0,0,0,0,0,0,0,0,0,0,0,0,0,0,0,0,0,0,0,0,0,0,0,0,0,0,0,0,0,0,0,0,0,0,0,0,0,0,0,0,0,0,1
1,0,13,0,0,0,0,0,0,1,0,0,0,0,0,0,0,0,0,0,1,14,14,14,14,14,14,14,14,14,14,14,14,14,14,14,14,14,14,4,20,11,11,11,11,11,21,2,2,2,2,3,2,2,6,2,2,2,2,2,2,2,2,16,0,0,0,0,0,0,0,15,2,2,2,2,2,2,2,2,2,2,2,2,2,2,2,2,2,2,2,2,2,2,16,0,0,0,0,1
1,0,0,0,0,0,0,0,0,1,0,0,13,0,0,0,0,13,0,0,1,14,14,14,14,14,14,14,14,14,14,14,14,14,14,14,14,14,14,1,0,0,0,0,0,0,0,0,0,0,0,1,0,0,0,0,12,0,0,0,0,0,0,1,0,0,0,0,0,0,0,1,14,14,14,14,14,14,14,14,14,14,14,14,14,14,14,14,14,14,14,14,14,14,1,0,0,0,0,1
1,0,0,0,0,0,0,0,0,1,0,0,0,0,0,0,0,0,0,0,1,14,14,14,14,14,14,14,14,14,14,14,14,14,14,14,14,14,14,1,0,0,0,0,0,0,0,0,0,0,0,1,0,0,0,0,0,0,0,0,0,0,0,1,0,0,0,0,0,0,0,1,14,14,14,14,14,14,14,14,14,14,14,14,14,14,14,14,14,14,14,14,14,14,1,0,0,0,0,1
1,0,0,0,0,0,0,12,0,1,0,0,0,0,0,0,0,0,0,0,1,14,14,14,14,14,14,14,14,14,14,14,14,14,14,14,14,14,14,1,0,0,0,0,0,0,0,0,0,0,0,1,0,26,0,0,0,12,0,0,13,27,0,1,0,0,0,0,0,0,0,1,14,14,14,14,14,14,14,14,14,14,14,14,14,14,14,14,14,14,14,14,14,14,1,0,0,0,0,1
1,0,0,0,0,0,0,0,0,1,0,0,0,0,0,10,0,0,0,0,1,14,14,14,14,14,14,14,14,14,14,14,14,14,14,14,14,14,14,1,0,0,0,0,0,0,0,0,0,0,0,1,0,0,0,0,0,0,0,0,0,0,0,1,0,0,0,0,0,0,0,17,2,2,2,2,2,2,2,2,2,2,2,2,2,2,2,2,2,2,2,2,2,2,18,0,0,0,0,1
1,0,0,0,0,0,0,0,0,1,0,0,0,0,0,1,0,0,0,0,1,14,14,14,14,14,14,14,14,14,14,14,14,14,14,14,14,14,14,1,0,0,0,0,0,0,0,0,0,0,0,1,0,0,0,0,0,0,12,0,0,0,0,1,0,0,0,0,0,0,0,0,0,0,0,0,0,0,0,0,0,0,0,0,0,0,0,0,0,0,0,0,0,0,0,0,0,0,0,1
1,0,0,0,0,12,0,0,0,1,0,0,0,0,0,1,0,0,0,0,1,14,14,14,14,14,14,14,14,14,14,14,14,14,14,14,14,14,14,1,0,0,12,0,0,0,0,0,12,0,0,1,0,0,0,0,0,0,0,0,0,0,0,1,0,0,0,0,0,0,0,0,0,13,0,0,0,0,26,26,0,0,0,13,0,0,0,0,0,26,26,0,0,0,13,0,0,0,0,1
1,0,0,0,0,0,0,0,0,1,0,0,0,0,0,1,0,0,0,0,1,14,14,14,14,14,14,14,14,14,14,14,14,14,14,14,14,14,14,1,0,0,0,0,0,12,0,0,0,0,0,1,0,0,0,15,2,2,2,2,2,2,2,5,0,0,0,0,0,0,0,0,0,0,0,0,0,0,0,0,0,0,0,0,0,0,0,0,0,0,0,0,0,0,0,0,0,0,0,1
1,0,0,0,0,0,0,0,0,1,0,0,12,0,0,1,0,0,12,0,1,14,14,14,14,14,14,14,14,14,14,14,14,14,14,14,14,14,14,1,0,0,0,0,0,0,0,0,0,0,0,1,0,0,0,1,14,14,14,14,14,14,14,4,2,2,2,2,2,2,2,2,2,2,2,2,2,2,3,2,2,2,2,2,2,2,2,2,2,2,2,2,2,2,2,3,2,2,2,5
1,0,0,0,0,0,0,0,13,22,0,0,0,0,0,1,0,0,0,0,1,14,14,14,14,14,14,14,14,14,14,14,14,14,14,14,14,14,14,1,0,0,0,0,0,0,0,0,0,0,0,1,0,0,0,1,14,14,14,14,14,14,14,1,0,0,0,0,0,0,0,0,0,0,0,0,0,0,1,14,14,14,14,14,14,14,14,14,14,14,14,14,14,14,14,1,0,0,0,1
1,0,0,0,0,0,0,0,0,24,0,0,0,0,0,1,0,0,0,0,1,14,14,14,14,14,14,14,14,14,14,14,14,14,14,14,14,14,14,1,0,0,0,0,0,0,0,0,0,0,0,1,0,0,0,1,14,14,14,14,14,14,14,1,0,0,0,0,0,0,0,12,0,0,0,0,26,0,1,14,14,14,14,14,14,14,14,14,14,14,14,14,14,14,14,1,26,0,26,1
1,0,26,0,0,0,0,0,0,24,0,0,0,0,0,9,0,0,0,0,1,14,14,14,14,14,14,14,14,14,14,14,14,14,14,14,14,14,14,1,0,0,0,13,0,0,0,13,0,0,0,1,0,0,0,1,14,14,14,14,14,14,14,1,0,0,0,0,0,0,0,0,0,0,12,0,0,0,1,14,14,14,14,14,14,14,14,14,14,14,14,14,14,14,14,1,0,0,0,1
1,0,0,0,0,0,0,0,0,24,0,0,0,0,0,0,0,0,0,0,1,14,14,14,14,14,14,14,14,14,14,14,14,14,14,14,14,14,14,1,0,0,0,0,0,0,0,0,0,0,0,1,0,0,0,1,14,14,14,14,14,14,14,1,0,0,0,0,0,0,0,12,0,0,0,0,26,0,1,14,14,14,14,14,14,14,14,14,14,14,14,14,14,14,14,1,0,12,0,1
1,0,0,0,0,0,0,0,0,24,0,0,0,0,0,0,0,0,0,0,4,2,2,2,2,2,2,2,2,2,2,2,2,2,2,2,2,2,3,18,0,0,0,0,0,0,0,0,0,0,0,1,0,0,0,1,14,14,14,14,14,14,14,1,0,0,0,0,0,0,0,0,0,0,12,0,0,0,1,14,14,14,14,14,14,14,14,14,14,14,14,14,14,14,14,1,0,12,0,1
1,0,0,0,0,0,0,0,13,23,0,0,0,0,0,0,0,0,0,0,1,0,0,0,0,0,0,0,0,0,0,0,0,0,0,0,0,0,1,0,0,0,0,0,0,0,0,0,0,0,0,1,0,0,0,17,2,2,2,2,2,2,2,18,0,0,0,0,0,0,0,12,0,0,0,0,26,0,1,14,14,14,14,14,14,14,14,14,14,14,14,14,14,14,14,1,0,0,0,1
1,0,0,0,0,0,0,0,0,1,0,0,0,0,0,0,0,0,0,0,1,0,0,0,0,0,0,0,0,0,13,0,13,0,26,0,0,0,1,0,0,0,8,2,2,2,2,2,7,0,0,1,0,0,0,0,0,0,0,0,0,0,0,0,0,0,0,0,0,0,0,0,0,0,0,0,0,0,1,14,14,14,14,14,14,14,14,14,14,14,14,14,14,14,14,1,0,0,0,1
17,2,2,2,2,2,2,2,2,6,2,2,2,3,20,11,11,11,11,21,5,0,0,0,0,0,0,0,0,0,0,0,0,0,0,0,0,0,1,0,0,0,0,0,0,0,0,0,0,0,0,1,0,0,0,0,0,0,0,0,0,0,0,0,0,0,0,0,0,0,0,0,0,0,0,0,0,0,1,14,14,14,14,14,14,14,14,14,14,14,14,14,14,14,14,1,0,0,0,1
14,14,14,14,14,14,14,14,14,14,14,14,14,1,0,0,0,0,0,0,0,0,0,0,0,0,0,0,0,0,12,0,0,0,0,0,0,0,1,0,0,13,0,0,0,0,0,0,0,13,0,1,0,0,0,0,0,0,0,0,0,0,0,0,0,0,0,8,2,2,2,2,2,2,2,2,2,2,5,14,14,14,14,14,14,14,14,14,14,14,14,14,14,14,14,1,0,0,0,1
14,14,14,14,14,14,14,14,14,14,14,14,14,1,0,0,0,0,0,0,0,0,0,0,0,0,0,0,0,0,0,0,0,0,26,0,0,0,1,0,0,0,0,0,0,0,0,0,0,0,0,9,0,0,0,0,0,0,0,0,0,0,0,0,0,0,0,0,0,0,0,0,0,0,0,0,0,0,1,14,14,14,14,14,14,14,14,14,14,14,14,14,14,14,14,1,0,0,0,1
14,14,14,14,14,14,14,14,14,14,14,14,14,1,0,0,0,0,0,0,0,0,0,0,0,0,0,0,0,0,12,0,0,0,0,0,26,0,1,0,0,0,0,0,13,0,13,0,0,0,0,0,0,0,0,0,0,0,0,0,0,0,0,0,0,0,0,0,0,0,0,0,0,0,0,0,0,0,1,14,14,14,14,14,14,14,14,14,14,14,14,14,14,14,14,1,0,0,0,1
14,14,14,14,14,14,14,14,14,14,14,14,14,1,0,0,0,0,0,0,0,0,0,0,0,0,0,0,0,0,0,0,0,0,0,0,0,0,1,0,0,0,0,0,0,0,0,0,0,0,0,0,0,0,0,0,0,0,0,0,0,0,0,0,0,0,0,0,0,0,0,0,0,13,0,0,0,0,4,2,2,2,2,2,2,2,3,2,2,2,2,2,2,2,2,18,0,0,0,1
14,14,14,14,14,14,14,14,14,14,14,14,14,1,0,0,0,0,0,0,0,0,0,0,0,0,0,0,0,0,12,0,0,0,26,0,0,0,1,0,0,0,0,0,0,0,0,0,0,0,0,0,0,0,0,0,0,0,0,0,0,0,0,0,0,0,0,0,0,0,0,0,0,0,0,0,0,0,1,0,0,0,27,0,0,0,1,27,0,12,0,0,0,0,0,0,0,0,0,1
14,14,14,14,14,14,14,14,14,14,14,14,14,1,0,0,0,0,0,0,0,0,0,0,0,0,0,0,0,0,0,0,0,0,0,0,0,0,1,0,0,0,0,0,0,0,0,0,0,0,0,0,0,0,0,0,0,0,0,0,0,0,0,12,0,12,0,0,0,0,0,0,0,0,0,13,0,0,1,0,26,0,26,0,26,0,1,0,12,0,0,0,0,0,0,0,0,0,0,1
14,14,14,14,14,14,14,14,14,14,14,14,14,1,0,0,0,0,0,0,0,0,0,0,0,0,0,0,13,0,13,0,0,0,26,0,0,0,4,20,11,11,11,11,11,11,11,21,2,2,2,2,2,2,2,2,2,2,16,0,0,0,0,0,0,0,0,0,0,0,0,0,0,0,0,0,0,0,1,0,0,0,0,0,0,0,1,12,0,0,0,0,0,0,0,0,0,0,0,1
14,14,14,14,14,14,14,14,14,14,14,14,14,1,0,0,0,0,0,0,0,0,0,0,0,0,0,0,0,0,0,0,0,0,0,0,0,0,1,0,0,0,0,0,0,0,0,0,0,0,0,0,0,0,0,0,0,0,1,0,0,0,12,0,0,0,0,0,0,0,0,0,0,0,0,0,0,0,1,0,0,0,0,0,0,0,1,0,0,0,0,0,0,0,0,0,0,0,0,1
14,14,14,14,14,14,14,14,14,14,14,14,14,1,0,0,0,0,0,0,8,2,2,2,2,2,2,2,2,2,2,2,2,2,2,2,2,2,5,0,0,0,0,0,0,0,0,0,0,0,0,0,0,0,0,0,0,0,1,0,12,0,0,0,0,0,0,0,0,0,0,0,0,0,0,0,0,0,1,0,13,0,13,0,13,0,1,0,0,0,0,0,0,0,0,0,0,0,0,1
14,14,14,14,14,14,14,14,14,14,14,14,14,1,0,0,0,0,0,0,0,0,0,0,0,0,0,0,0,0,0,0,0,0,0,26,0,0,1,0,0,0,0,0,0,0,0,0,0,0,0,0,0,0,0,0,0,0,1,0,0,0,0,0,0,0,0,0,0,0,0,0,0,0,0,0,0,0,1,0,0,0,0,0,0,0,1,0,0,0,0,0,0,0,0,13,0,0,0,1
14,14,14,14,14,14,14,14,14,14,14,14,14,1,0,0,0,0,0,0,0,0,0,0,0,0,0,0,0,0,0,0,0,0,0,0,27,0,1,0,0,0,0,0,0,0,0,0,0,0,0,0,0,0,0,0,0,0,1,0,0,0,0,0,0,15,2,2,2,2,2,16,0,0,0,0,0,0,1,0,0,0,0,0,0,0,1,0,0,0,0,0,0,0,0,0,0,0,0,1
14,14,14,14,14,14,14,14,14,14,14,14,14,1,0,0,0,0,0,0,0,0,0,0,0,0,0,0,0,0,0,0,0,0,12,0,0,26,1,0,0,0,0,0,0,0,0,0,0,0,0,0,0,0,0,0,0,0,1,0,0,0,0,0,0,1,14,14,14,14,14,1,0,0,0,0,0,0,1,0,0,0,0,0,0,0,1,0,0,0,0,0,0,0,0,0,0,0,0,1
14,14,14,14,14,14,14,14,14,14,14,14,14,1,0,0,0,0,0,0,0,0,0,0,0,0,0,0,0,0,0,0,0,12,0,0,0,0,1,0,0,0,0,0,0,15,20,11,11,11,11,11,11,11,11,11,21,2,5,0,0,0,0,0,0,1,14,14,14,14,14,1,0,0,0,0,0,0,1,0,0,0,0,0,0,0,1,0,0,0,0,0,13,13,0,0,0,0,0,1
14,14,14,14,14,14,14,14,14,14,14,14,14,1,0,0,0,0,0,0,0,0,0,0,0,0,0,0,0,0,0,0,0,0,0,0,0,0,1,0,0,0,0,0,0,1,0,0,0,0,0,0,0,0,0,0,0,0,1,0,0,0,0,0,0,1,14,14,14,14,14,1,0,0,0,0,0,0,1,0,0,0,0,0,0,0,1,0,0,0,0,0,0,0,0,0,0,0,0,1
14,14,14,14,14,14,14,14,14,14,14,14,14,1,0,0,0,0,0,0,0,0,0,0,0,0,0,0,0,0,0,0,0,0,0,0,0,0,1,0,0,0,0,0,0,1,0,0,0,0,0,0,0,0,0,0,0,0,1,0,0,0,0,0,0,1,14,14,14,14,14,1,0,0,0,0,0,0,1,0,0,12,0,12,0,0,1,0,0,13,0,0,0,0,0,0,0,0,0,1
14,14,14,14,14,14,14,14,14,14,14,14,14,1,0,0,0,12,0,0,0,0,12,0,0,0,0,12,0,0,0,0,12,0,0,0,0,0,1,0,0,0,0,0,0,1,0,0,0,0,0,0,0,0,0,0,0,0,1,0,0,0,0,0,0,1,14,14,14,14,14,1,0,0,0,0,0,0,1,0,0,0,12,0,0,0,1,0,0,0,0,0,0,0,0,0,0,0,0,1
14,14,14,14,14,14,14,14,14,14,14,14,14,1,0,0,0,0,0,0,0,0,0,0,0,0,0,0,0,0,0,0,0,0,0,0,0,0,1,0,0,0,0,0,0,1,0,0,0,0,0,0,0,0,0,0,0,0,1,0,0,0,0,0,0,1,14,14,14,14,14,1,0,0,0,0,0,0,1,0,0,0,0,0,0,0,1,0,0,0,0,0,0,0,0,0,0,0,0,1
14,14,14,14,14,14,14,14,14,14,14,14,14,1,0,0,0,0,0,0,0,0,0,0,0,0,0,0,0,0,0,0,0,0,0,0,0,0,1,0,0,0,0,0,0,1,0,0,12,0,0,0,0,0,0,12,0,0,1,0,0,0,0,0,0,1,14,14,14,14,14,1,0,0,0,0,0,0,1,0,0,0,0,0,0,0,1,0,0,0,0,0,0,0,0,0,0,0,0,1
14,14,14,14,14,14,14,14,14,14,14,14,14,1,0,0,0,0,0,0,0,0,0,0,0,0,0,0,0,0,0,0,0,0,0,0,0,0,1,0,0,0,0,0,0,1,0,0,0,12,0,13,13,0,12,0,0,0,1,0,0,0,0,0,0,17,2,2,2,2,2,18,0,0,0,0,0,0,1,0,0,0,12,0,0,0,1,0,0,0,0,0,0,0,0,0,0,0,0,1
14,14,14,14,14,14,14,14,14,14,14,14,14,1,0,0,0,13,13,0,0,0,0,0,0,12,0,0,0,0,12,0,0,0,12,0,0,0,1,0,0,12,12,0,0,1,0,0,0,0,0,0,0,0,0,0,0,0,1,0,0,0,0,0,0,0,0,0,0,0,0,0,0,0,0,0,0,0,1,0,0,12,0,12,0,0,1,0,0,0,0,0,0,0,0,0,0,0,0,1
14,14,14,14,14,14,14,14,14,14,14,14,14,1,0,0,0,13,13,0,0,0,0,0,0,0,0,0,0,0,0,0,0,0,0,0,0,0,1,0,0,0,0,0,0,1,0,0,0,0,26,26,26,26,0,0,0,27,1,0,0,0,0,0,0,0,0,0,0,0,0,0,0,0,0,0,0,0,1,0,0,0,0,0,0,0,1,0,0,0,0,0,0,0,0,0,0,0,0,1
14,14,14,14,14,14,14,14,14,14,14,14,14,1,26,0,0,0,0,0,0,0,0,0,0,0,0,0,0,0,0,0,0,0,0,0,0,0,1,26,0,26,15,2,2,6,2,2,2,2,2,2,2,2,2,2,2,2,5,0,0,0,0,0,0,0,0,0,0,0,0,0,0,13,0,0,0,0,1,0,12,0,0,0,12,0,1,0,0,0,0,0,0,0,0,0,0,0,0,1
14,14,14,14,14,14,14,14,14,14,14,14,14,1,0,0,0,0,0,0,0,0,0,0,0,0,0,0,0,0,0,0,0,0,0,0,0,0,4,2,2,2,5,14,14,14,14,14,14,14,14,14,14,14,14,14,14,14,1,0,0,0,0,0,0,0,0,0,0,0,0,0,0,0,0,0,0,0,1,0,0,0,0,0,0,0,4,2,2,2,2,2,2,2,2,2,2,16,12,1
14,14,14,14,14,14,14,14,14,14,14,14,14,1,27,0,26,0,0,0,0,0,0,0,0,0,0,0,0,0,0,0,12,12,0,0,0,0,1,0,27,0,1,14,14,14,14,14,14,14,14,14,14,14,14,14,14,14,1,0,0,0,0,0,12,0,0,0,0,0,0,0,0,0,0,13,0,0,1,0,0,0,0,0,0,0,1,14,14,14,14,14,14,14,14,14,14,1,0,1
15,2,2,2,2,2,2,2,2,2,2,2,2,19,2,2,2,2,2,2,2,2,2,2,2,2,2,2,20,11,11,11,11,11,11,11,11,21,5,26,26,26,1,14,14,14,14,14,14,14,14,14,14,14,14,14,14,14,1,0,0,0,0,0,0,0,0,0,0,0,0,0,0,0,0,0,0,0,9,0,0,0,0,0,0,0,1,14,14,14,14,14,14,14,14,14,14,1,0,1
1,0,0,0,0,0,0,0,0,0,0,0,0,1,0,0,0,0,0,0,0,0,0,0,0,0,0,0,0,0,0,0,0,0,0,0,0,0,1,0,0,0,1,14,14,14,14,14,14,14,14,14,14,14,14,14,14,14,1,0,0,0,12,0,0,0,0,0,0,0,0,0,0,0,0,0,0,0,0,0,0,0,0,0,0,0,1,14,14,14,14,14,14,14,14,14,14,1,0,1
1,0,0,0,0,0,0,0,0,26,0,0,0,1,0,0,0,0,0,0,0,0,0,0,0,0,0,0,0,0,0,0,0,0,0,0,0,0,1,0,0,0,1,14,14,14,14,14,14,14,14,14,14,14,14,14,14,14,1,0,0,0,0,0,0,0,0,0,0,0,0,0,0,0,0,0,0,0,0,0,0,0,0,0,0,0,1,14,14,14,14,14,14,14,14,14,14,1,0,1
1,0,0,0,0,0,0,0,0,0,0,0,0,1,0,0,26,26,0,0,0,0,0,0,0,0,0,0,0,0,0,0,0,0,0,0,0,0,1,13,13,13,1,14,14,14,14,14,14,14,14,14,14,14,14,14,14,14,1,0,12,0,0,0,0,0,0,0,0,0,0,0,0,0,0,0,0,0,0,0,0,0,0,0,0,0,1,14,14,14,14,14,14,14,14,14,14,1,0,1
1,0,0,0,13,0,0,0,27,0,0,0,0,1,0,0,0,0,0,0,0,12,0,0,0,0,0,0,0,0,0,0,0,0,0,0,0,0,1,0,0,0,1,14,14,14,14,14,14,14,14,14,14,14,14,14,14,14,1,0,0,0,0,0,0,0,0,0,0,0,0,0,0,0,0,0,0,0,0,0,0,0,0,0,0,0,1,14,14,14,14,14,14,14,14,14,14,1,0,1
1,0,0,0,0,0,0,0,0,0,0,0,0,1,0,0,0,0,0,0,0,0,0,0,0,0,0,0,0,0,0,0,0,0,0,0,0,0,1,0,0,0,1,14,14,14,14,14,14,14,14,14,14,14,14,14,14,14,4,2,2,2,2,2,2,2,2,7,0,0,0,0,0,0,0,0,8,2,2,2,2,2,2,2,2,2,6,2,2,2,2,2,2,2,2,2,2,18,0,1
1,0,0,0,0,0,13,0,0,26,0,0,0,1,0,0,0,0,0,12,0,0,0,0,0,0,0,0,0,0,0,0,0,0,0,0,0,0,1,0,0,0,1,14,14,14,14,14,14,14,14,14,14,14,14,14,14,14,1,0,0,0,0,0,0,0,0,0,0,0,0,0,0,0,0,0,0,0,0,0,0,0,0,0,0,0,0,0,0,0,0,0,0,0,0,0,0,0,0,1
1,0,0,0,0,0,0,0,0,0,0,0,0,1,0,0,12,0,0,0,0,0,0,0,0,0,0,0,0,0,13,0,0,0,0,0,0,0,1,0,0,0,1,14,14,14,14,14,14,14,14,14,14,14,14,14,14,14,1,0,0,0,0,0,0,12,0,0,0,0,0,0,0,0,0,0,0,0,0,0,0,0,12,0,0,0,0,0,0,0,0,0,0,0,0,0,0,0,0,1
1,0,0,0,0,0,0,0,0,13,0,0,0,1,0,0,0,0,0,0,0,0,0,0,0,0,0,0,0,0,0,0,0,0,0,0,0,0,1,0,0,0,1,14,14,14,14,14,14,14,14,14,14,14,14,14,14,14,1,0,0,0,0,0,0,0,0,0,0,0,0,0,0,0,0,0,0,0,0,0,0,0,0,0,0,0,0,0,0,0,0,13,0,13,0,13,0,0,0,1
1,0,0,0,0,0,0,0,0,0,0,0,0,1,0,0,0,0,0,0,0,0,0,0,0,0,0,0,0,0,0,0,0,13,0,0,0,0,1,0,0,0,17,2,2,2,2,2,2,2,2,2,2,2,2,2,2,2,18,0,0,0,0,0,0,0,0,0,0,0,0,0,12,0,0,0,0,0,0,0,0,0,0,0,0,0,0,0,0,0,0,0,0,0,0,0,0,0,0,1
1,0,0,0,0,0,0,0,0,0,0,0,0,1,0,0,0,0,0,0,0,0,0,0,0,0,0,0,0,0,0,0,0,0,0,0,0,0,1,0,0,0,0,0,12,0,0,0,0,0,0,0,12,0,0,0,0,0,0,0,0,0,0,0,0,12,0,0,0,0,0,0,0,0,0,0,0,0,0,0,0,0,12,0,0,0,0,0,0,0,0,0,0,0,0,0,0,0,0,1
1,0,0,0,0,0,0,0,0,0,0,0,0,1,0,0,0,0,0,0,0,0,0,0,0,0,0,0,0,0,0,0,0,0,0,0,0,0,1,0,0,0,0,0,0,12,0,0,0,0,0,0,0,12,0,0,0,0,0,0,0,0,0,0,0,0,0,0,0,0,0,0,0,0,0,0,0,0,0,0,0,0,0,0,0,0,0,0,0,0,0,0,0,0,0,0,0,0,0,1
1,0,0,0,0,0,0,0,0,0,0,0,0,1,0,0,0,0,0,0,0,0,0,0,0,0,0,0,0,0,0,0,0,0,0,0,0,0,4,2,2,2,2,2,2,2,2,2,2,2,2,2,2,2,2,2,2,2,2,2,3,2,2,2,2,2,2,2,2,2,2,3,2,2,2,2,2,2,2,2,2,2,2,2,2,2,16,0,0,0,0,0,0,0,0,0,0,0,0,1
1,0,0,0,0,0,15,2,2,2,2,2,2,18,0,0,0,0,0,0,0,0,0,0,0,0,0,0,0,0,0,0,0,0,0,0,0,0,22,0,0,0,0,0,0,0,0,0,0,0,0,0,0,0,0,0,0,0,0,0,22,0,0,0,0,0,0,0,0,0,0,1,14,14,14,14,14,14,14,14,14,14,14,14,14,14,1,0,0,0,0,0,0,0,0,0,0,0,0,1
1,0,0,0,0,0,1,0,0,0,0,0,0,0,0,0,0,0,0,0,0,0,0,0,0,0,0,0,0,0,0,0,0,0,12,0,0,0,24,0,0,0,0,0,0,0,0,0,0,0,0,0,0,0,0,0,0,0,0,0,24,0,0,0,0,0,0,0,0,0,0,1,14,14,14,14,14,14,14,14,14,14,14,14,14,14,1,0,0,0,0,0,0,0,0,0,0,0,0,1
1,0,0,0,0,0,1,0,0,0,0,0,0,0,0,0,0,0,0,0,12,0,0,0,0,0,0,0,0,0,0,0,0,0,0,0,0,0,24,0,0,0,0,0,0,0,0,0,0,0,0,0,0,0,0,0,0,0,0,0,24,0,0,0,0,0,0,0,13,0,0,1,14,14,14,14,14,14,14,14,14,14,14,14,14,14,1,0,0,0,0,0,0,0,0,0,0,0,0,1
1,0,0,0,0,0,1,0,0,0,0,0,0,0,0,0,0,0,0,0,0,0,0,0,0,0,0,0,0,0,0,0,0,0,12,0,0,0,24,0,0,0,0,0,12,0,0,0,0,13,0,0,0,0,12,0,0,0,0,0,24,0,0,0,0,0,0,0,13,0,0,1,14,14,14,14,14,14,14,14,14,14,14,14,14,14,1,0,0,0,0,0,0,0,0,0,0,0,0,1
1,0,12,0,12,0,1,0,0,0,0,13,0,0,0,0,0,0,0,0,0,0,0,0,0,0,0,0,0,0,0,0,0,0,0,0,0,0,24,0,0,0,0,0,0,0,0,0,0,0,0,0,0,0,0,0,0,0,0,0,24,0,0,0,0,0,0,0,0,0,0,1,14,14,14,14,14,14,14,14,14,14,14,14,14,14,1,0,0,0,0,0,12,12,12,0,0,0,0,1
1,0,0,0,0,0,1,0,0,0,0,0,0,0,0,0,0,0,0,0,13,0,0,0,0,0,0,0,0,0,0,0,0,0,0,0,0,0,23,0,0,0,0,0,0,0,0,0,0,0,0,0,0,0,0,0,0,0,0,0,23,0,0,0,0,0,0,0,0,0,0,1,14,14,14,14,14,14,14,14,14,14,14,14,14,14,1,0,0,0,0,0,0,0,0,0,0,0,0,1
1,0,0,0,0,0,1,26,27,12,0,0,0,0,0,0,0,0,0,0,0,0,0,0,0,0,0,0,0,8,2,2,2,2,2,2,2,2,19,2,2,2,2,2,2,2,2,2,2,2,2,2,2,2,2,2,2,2,2,2,5,0,0,0,0,0,0,0,0,0,0,1,14,14,14,14,14,14,14,14,14,14,14,14,14,14,1,0,0,0,0,0,0,0,0,0,0,0,0,1
1,0,0,0,0,0,1,0,0,0,0,0,0,0,0,0,0,0,0,0,0,0,0,0,0,0,0,0,0,0,0,0,0,0,0,0,0,0,22,0,0,0,0,0,0,0,0,0,0,0,0,0,0,0,0,0,0,0,0,0,1,0,0,0,13,0,0,0,0,0,0,1,14,14,14,14,14,14,14,14,14,14,14,14,14,14,1,0,0,0,0,0,0,0,0,0,0,0,0,1
1,0,0,0,0,0,1,0,0,0,0,13,0,0,0,0,0,0,0,0,0,0,0,0,0,0,0,0,0,0,0,0,0,0,0,0,0,0,24,0,0,0,0,0,0,0,0,0,0,13,0,0,0,0,0,0,13,0,0,0,1,0,0,0,0,13,0,0,0,0,0,1,14,14,14,14,14,14,14,14,14,14,14,14,14,14,1,0,0,0,0,0,0,0,0,0,0,0,0,1
1,0,0,0,0,0,1,0,0,0,0,0,0,0,0,0,0,0,0,0,0,0,0,0,0,0,0,0,0,0,0,13,0,0,0,0,0,0,24,0,0,0,0,0,0,0,0,0,0,0,0,0,0,0,0,0,0,0,0,0,1,0,0,0,0,0,0,0,0,0,0,1,14,14,14,14,14,14,14,14,14,14,14,14,14,14,1,0,0,0,0,0,0,0,0,0,0,0,0,1
1,0,0,0,0,0,17,2,2,2,2,2,2,2,2,2,2,2,0,0,0,0,0,0,0,0,0,0,0,0,0,0,0,0,0,0,0,0,24,0,0,0,0,0,0,0,0,12,0,0,0,0,0,0,0,0,0,0,0,0,1,0,0,0,0,0,0,0,0,0,0,1,14,14,14,14,14,14,14,14,14,14,14,14,14,14,1,0,0,13,0,0,0,0,0,0,0,0,0,1
1,0,0,0,0,0,0,0,0,0,0,0,0,0,0,0,0,0,0,0,0,0,0,0,0,0,0,0,13,0,0,0,0,0,0,0,0,0,24,0,0,0,0,0,0,0,0,0,0,0,0,0,26,0,26,0,0,0,27,0,1,0,0,0,0,0,0,0,12,0,0,17,2,2,2,2,2,2,2,2,2,2,2,2,2,2,18,0,0,0,13,0,0,0,0,0,0,0,0,1
1,0,0,0,0,0,0,0,0,0,0,0,0,0,0,0,0,0,0,0,0,0,0,0,0,0,0,0,0,0,0,0,0,0,0,0,0,0,24,0,0,0,0,0,0,0,0,12,0,0,0,0,0,0,0,0,0,0,0,0,1,0,0,0,0,0,12,0,0,0,0,0,0,0,0,0,0,0,0,0,0,0,0,0,0,0,0,0,0,0,0,13,0,0,0,0,0,0,0,1
1,0,0,13,0,0,0,0,0,0,26,0,0,0,0,0,0,0,0,0,0,0,0,0,0,13,0,0,0,0,0,0,0,0,0,0,0,0,24,0,0,0,0,0,0,0,0,0,0,13,0,0,0,0,0,0,0,0,26,0,1,0,0,0,12,0,0,0,0,0,0,0,0,0,0,0,26,0,0,0,0,26,0,0,0,0,0,0,0,0,0,0,0,0,0,0,0,0,0,1
1,0,0,0,0,0,0,0,0,0,0,0,0,0,0,0,0,0,0,0,0,0,0,0,0,0,0,0,0,0,0,0,0,0,0,0,0,0,23,0,0,0,0,0,0,0,0,0,0,0,0,0,0,0,0,0,0,0,0,0,1,0,0,0,0,0,0,0,0,0,0,0,0,0,0,0,0,0,0,0,0,0,0,0,0,0,0,0,0,0,0,0,0,0,0,0,0,0,0,1
17,2,2,2,2,2,2,2,2,2,2,2,2,2,2,2,2,2,2,2,2,2,2,2,2,2,2,2,2,2,2,2,2,2,2,2,2,2,6,2,2,2,2,2,2,2,2,2,2,2,2,2,2,2,2,2,2,2,2,2,6,2,2,2,2,2,2,2,2,2,2,2,2,2,2,2,2,2,2,2,2,2,2,2,2,2,2,2,2,2,2,2,2,2,2,2,2,2,2,18
